111111111111111111111111111111111111111111111111111111111111
10000000000C000000000000000000000000000C00000000000000000001
101100011100000000000000000000000000000C00000000000000000001
100000000000000000000000000000000000000C0000000000000000PE11
100000000000000000000000000000000000000C00000000000000000001
100000000000000000000000000000000000000C00000000000000000001
100000000000000000000000000000000000000C00000000000000000001
111111111111111111111111111111111111111111111111111111111111
